***************
*             *
*             *
*             *
*             *
*             *
*             *
*             *
*             *
*             *
*             *
*             *
*             *
*            $*
***************
