***************
*             *
*             *
*             *
*     *********
*             *
*             *
*             *
*********     *
*             *
*             *
*             *
*    **********
*        $    *
***************
