***************
*        *    *
*        *    *
*             *
*********     *
*             *
*      ********
*             *
*********     *
*            *
* * ******    *
* *      *    *
* ****** *    *
*      *$*    *
***************
